47
14															
13 13 13 13 13 13 13 13 13 13 13 13 13 13 13 13 13 13 13 13 13 13 13 13 13 13 13 13 13 13 13 13 13 13 13 13 13 13 13 13 13 13 13 13 13 13 13 
13 0  0  0  0  0  0  0  0  0  0  0  0  0  0  0  0  0  0  0  0  0  0  0  0  0  0  0  0  0  0  0  0  0  2  0  0  0  0  0  0  0  0  0  0  0  13
13 0  0  0  0  0  0  0  0  0  0  0  0  0  0  0  0  0  2  0  0  0  0  0  0  0  0  0  2  0  0  0  0  0  14 0  2  0  0  0  0  0  0  0  0  0  13
13 2  0  0  2  0  0  0  0  0  0  0  0  0  0  0  0  0  14 0  0  0  0  0  0  0  0  0  14 0  0  0  0  0  0  0  14 0  0  0  0  0  0  0  0  0  13
13 14 0  0  14 0  0  0  0  2  0  0  0  2  0  0  0  2  2  0  0  0  0  0  0  0  0  0  0  0  0  0  0  0  0  0  0  0  0  2  0  0  0  0  0  0  13
13 0  0  0  0  0  0  0  0  14 0  0  0  14 0  0  0  14 14 0  0  0  2  0  0  0  2  0  0  0  0  0  0  0  0  0  0  0  0  14 0  0  0  0  0  0  13
13 0  2  0  0  0  0  0  0  0  0  0  0  0  0  0  2  0  0  0  0  0  14 0  0  0  14 0  0  2  0  0  0  0  0  0  2  0  0  0  0  0  0  0  0  2  13
13 0  14 0  0  0  2  0  0  0  0  0  0  0  0  0  14 0  0  0  0  0  0  0  0  0  0  0  0  14 0  0  0  0  0  0  14 0  2  0  0  0  0  0  0  14 13
13 0  0  0  0  0  14 0  0  0  0  0  0  0  0  0  0  0  0  0  0  2  0  0  0  0  0  0  0  0  0  0  2  2  0  0  0  0  14 0  0  0  0  0  0  13 13
13 2  0  0  0  0  0  0  0  0  0  0  0  0  0  0  0  0  0  0  0  14 2  0  0  0  0  0  0  0  2  2  14 14 0  0  0  0  13 0  0  0  0  2  0  0  13
13 14 0  2  0  0  0  0  0  0  0  0  0  0  14 0  0  0  0  0  0  13 14 0  0  0  0  0  0  2  14 14 13 13 0  0  0  0  13 0  2  0  0  14 0  0  13
13 0  0  14 0  0  0  0  0  0  14 0  0  0  0  0  0  0  0  0  14 13 0  0  0  2  2  2  14 14 13 13 13 13 0  0  0  0  13 0  14 0  0  13 0  0  13
13 2  4  13 5  2  2  2  2  2  13 2  2  2  2  2  2  2  2  14 13 13 5  2  4  14 14 14 13 13 13 13 13 13 14 2  2  4  13 4  13 5  2  11 2  2  13
13 13 13 13 13 13 13 13 13 13 13 13 13 13 13 13 13 13 13 13 13 13 13 13 13 13 13 13 13 13 13 13 13 13 13 13 13 13 13 13 13 13 13 13 13 13 13 
